[
  {
    "type": "triangle",
    "name": "三角迷宫",
    "input": [9, 1],
    "output": [8, 7],
    "map": [
      [1, 1],
      [1, 0, 1],
      [1, 1, 1, 1],
      [1, 1, 1, 0, 1],
      [1, 0, 1, 0, 1, 1],
      [1, 0, 1, 1, 1, 1, 1],
      [1, 0, 0, 1, 0, 0, 1, 1],
      [1, 0, 1, 0, 0, 1, 0, 0, 1],
      [1, 0, 1, 0, 0, 1, 0, 0, 1, 1],
      [1, 1, 1, 1, 1, 1, 1, 1, 1, 1, 1]
    ]
  },
  {
    "type": "rect",
    "name": "矩形迷宫",
    "input": [9, 1],
    "output": [9, 7],
    "output2": [7, 9],
    "map": [
      [1, 1, 1, 1, 1, 1, 1, 1, 1, 1, 1],
      [1, 0, 1, 1, 1, 0, 1, 1, 1, 1, 1],
      [1, 0, 1, 1, 1, 0, 0, 0, 1, 1, 1],
      [1, 0, 0, 0, 0, 0, 1, 0, 0, 0, 1],
      [1, 0, 1, 1, 1, 0, 0, 0, 1, 0, 1],
      [1, 0, 0, 0, 1, 1, 0, 1, 1, 0, 1],
      [1, 0, 1, 0, 1, 1, 1, 1, 1, 0, 1],
      [1, 0, 1, 1, 0, 0, 0, 0, 1, 0, 1],
      [1, 0, 1, 0, 1, 1, 0, 0, 0, 0, 1],
      [1, 0, 1, 1, 1, 1, 0, 0, 0, 1, 1],
      [1, 1, 1, 1, 1, 1, 1, 1, 1, 1, 1]
    ]
  },
  {
    "type": "beehive",
    "name": "蜂巢迷宫",
    "input": [8, 0],
    "output": [2, 9],
    "map": [
        [1, 1, 1, 1, 1, 1, 1, 1, 1, 1, 1],
      [1, 1, 1, 1, 1, 1, 1, 1, 1, 1, 1],
        [1, 0, 1, 0, 1, 0, 1, 0, 1, 0, 1],
      [1, 1, 0, 1, 0, 0, 0, 0, 1, 0, 1],
        [1, 0, 0, 1, 1, 1, 0, 0, 1, 0, 1],
      [1, 0, 1, 0, 0, 1, 0, 1, 1, 1, 1],
        [1, 1, 1, 1, 1, 0, 0, 0, 0, 0, 1],
      [1, 0, 1, 0, 0, 0, 1, 1, 0, 0, 1],
        [0, 1, 1, 0, 0, 1, 0, 1, 0, 1, 1],
      [1, 1, 1, 1, 1, 1, 1, 1, 1, 1, 1],
        [1, 1, 1, 1, 1, 1, 1, 1, 1, 1, 1]
    ]
  }
]